
NO ./rscs/N256.xpm
SO ./rscs/S256.xpm
WE ./rscs/W256.xpm
EA ./rscs/E256.xpm

C 225,30,0
F 220,100,0

11111111111111111 1111111
10000000000100001 1000001	        
11111111100100001111000011111
        10000000000000000000111111111
    111110011011000001110000000000001
    100000000011000001110111111111111
    10000000000000000000000010001
    11111111111111111100010011111
                     100100011
                     111111001
        11111111111111000110111
11111111100001000001100000N0111
1000000000000011110001111100011
100111110011001  111011  1001
1001   11111111  100001  1001
1111   1111      100001  1001
                 100001  1111
                 111111