
NO ./rscs/N256.xpm
SO ./rscs/S256.xpm
WE ./rscs/W256.xpm
EA ./rscs/E256.xpm

C 225,30,0
F 220,100,0

1111111111111111111111111111
   100000000011000000000000111111
   11111101100000111000000      1
        1001000000000000000000001
111111111011000001110000000000001
100000000011000001110111111111111
11110111111111011100000010001
11110111111111011101010010001
11000000110101011100000010001
10000000000000001100000010001
10000000000000001101010010001
11000001110101011111011110N0111
11110111 1110101 101111000001
11111111 1111111 111111111111